-----------------------------------------------------------------------------------------------------------------------------------------------------
-----------------------------------------------------------------------------------------------------------------------------------------------------
---------------------------------------------------oo------------------------------------------------------------------------------------------------
--------------------------------------------?-----XXXX-------------------o---------------------------------------------------------------------------
-----------------------XX-----------------------------------------------XXX-------------------------oo-----------------------------------------------
----------------------------------------------------------------------------o------o-o----XXX------XXXX----------------------------XXXX--------------
---------------------E----------o----ooo------E--------XXXX--o---o---o------XXXX------------------------o----E---------------XXX---------------------
-----------------XXXXXX-------------------XXXXXX------------XXX-XXX-XXX--------------------------------XXX-------------------------------------------
--------------------------XXX------------------------------------------------------XXXX------------------------------------------------XXXX----------
--------------------------------------XXXX-----ooo--------------------------------------XXX-XXX----------------------EE-E----------------------------
-------------XXXXX-------------------------------E-----------------------------------------------------o----------XXXXXXXXXXXX-----------------------
-----------------------------------------XXXXXXXXXX----------------------------XXXX-------------XXX---XXXXX------------------------------------------
--------------------------oo---XXXXXXX-----------------------------E------------------------------------------------------------------------------XX-
XXXXXXXXXXX--------------XXX--------------------------------XXXXXXXXXXXXXXXX-----------------------------------XXX-------------------------XXXXXXXXXX
