---------------------------------------------------------------------------------------------------------------------------------------------------------------------------------------------------------------------------------------------------------------------------------------------------------------------------------------------------------------------------
---------------------------------------------------------------------------------------------------------------------------------------------------------------------------------------------------------------------------------------------------------------------------------------------------------------------------------------------------------------------------
--------------------------------------------------------------------------------------------------------------------------------------------------------------------------------------------------------------------------------------------------------------------------------------------------------------------------------XXXXXXXXXXXXXXXXXXXXXXXXXXXXXX-------------
--S-----------------------------------------------------------------------------------------------------------------------------------------------------------------------------------------------------------------------------------------------------------------------------------------------------------------------------XXXXXXXXXXXXXXXXXXXXXXXXXXXXXX-------------
-------------------------------------------------------------------------------------------------------------------------------------------------------------------------------------------------------------------------------------------------------------------------------------------------------------E------------------XXXXXXXXXXXXXXXXXXXXXXXXXXXXXX-------------
SS-SS---------------------XXXX----------XXXXXXXXXXXXXXXX--------------------------------------------------------------------------XX--------XXX--------XXXX---------XX----------------------XXXX------------------------------------------------------------------------------------------XX---------E-SSSSS------------------S-XXXXXXXXXXXXXXXXXXXXXXXXXXXXXX-------------
SS-SS----------------------------------------------------------------------------------------------------------------------------XXX--------XXX--------XXXX---------XX-------------------------------------------------------------------------------------------------------------------XXX------E-----------------------------XXXXXXXXXXXXXXXXXXXXXXXXXXXXXX-------------
--------------------------------------------------------------------------------------------------------------------------------XXXX--------XXX--------XXXX---------XX------------------------------------------------------------------------------------------------------------------XXXX------------------------------------XXXXXXXXXXXXXXXXXXXXXXXXXXXXXX-------------
S-S-SSS------------------------------------------------------------------------------------------------------------------------XXXXX--------XXX--------XXXX---------XX-----------------------------------------------------------------------------------------------------------------XXXXX---------------------------------S--XXXXXXXXXXXXXXXXXXXXXXXXXXXXXX-------------
S-S-SSS-----QQQQ--------------------------------------------------------------------------------------------------------------XXXXXXS-------XXX--------XXXX---------XX--------------------------------------------------------------------ooo-----------------------------------------XXXXXX------------SSS---------------------XXXXXXXXXXXXXXXXXXXXXXXXXXXXXX-------------
SSSSSSS-------------------------------------------------------------------B-------------------E------------------------------XXXXXXX--------XXX--------XXXX---------XX----------------------------------------------------------------------------------------------------------------XXXXXX-------------------------------E----XXXXXXXXXXXXXXXXXXXXXXXXXXXXXX-------------
-S-S-SS------------------------------------------------------------------Eb-------------------------------------------------XXXXXXXX--------XXX--------XXXX---------XX---------------B---------------------------E--------------------------------------------------------------------XXXXXX----------------------------------E-XXXXXXXXXXXXXXXXXXXXXXXXXXXXXX-------------
-S-S-SS-------------------------------------------------------E-----------BEE---------------------------E-EE---------------XXXXXXXXX--------XXX--------XXXX---------XX---------------b------------------------------------------EE-------------------EE-E------------------EE---X-----XXXXXX------------------------------------XXXXXXXXXXXXXXXXXXXXXXXXXXXXXX-----------X-
XXXXXXXXXXXXXXXXXXXXXXXXXXXXXXXX-----XXXXXXXXX--XX--XX--XXXXXXXXXXXXXXXXXXXXXXXXXXXXXXXXXXXXXXXXXXXXXXXXXXXXXXXXXXXXXXXXXXXXXXXXXXXXXX------XXX--------XXXX---------XXXXXXXXX---XXXXXXXXXXXXXXXXXXXXX--XX--XXXXXXXX--XXXXXXXXXXXXXXXXXXXXXXXX--XXXXXXXXXXXXXXXXXXXXXXXXXX--XXXXXX-----XXXXXX----------XXXXXXXXXXXXXXXXXXXXXXXXXXXXXXXXXXXXXXXXXXXXXXXXXXXXXXXX--XXXXXXXXXXX
