-------------------------------------------------------------------------------------------------------------------------------------------------------------------------------------------------
-------------------------------------------------------------------------------------------------------------------------------------------------------------------------------------------------
----------------------------------------------------------------------------------------E--------------------------------------------------------------------------------------------------------
-------------------------------------------------------------------------------------------------------------------------------------------------------------------------------------------------
-------------------------------------------------------------------------------------------------------------------------E-----------------------------------------------------------------------
--------------------------------------------------------------------------------SSSSSSSS?S--------S----S--------------------E------------SSSSSS----------XXXXXXXXXXXXXXXX--------------X---------
---------SSSSSSSSSSSSSSSS--------------------------ES--------------E-------------[]-------------------------------S--------<>--------------------------------[]-------[]-------------------------
-----------------------------------B--------S------------QQQ------<>-------------[]----------------------------------------[]--------------------------------[]-------[]-------------X-----------
-----------------------------------b------------------------------[]-------------[]----------------E-----------------------[]--------B-----------------------[]-------[]---------E---------------
--------------SSSSSS------E-------XXX--S-----------------------QQQQQQQQQQ--------[]---------------<>-----------------X-----XX-------XXXXESSSSSS--------------[]-------[]--------<----------------
---------------------------------XXXX--------------------------------------------<>---------------[]---------E---------------------XXXXXX--------------------<>-------<>--------[]---------------
--------------------------------XXXXX---------B---------------------------------------------------[]--------<>--------------------XXXXXXX---------------------------------------[]---------------
-------------------------------XXXXXX---------b-------------B---------------------E---------------[]--------[]-----X-------------XXXXXXXX----------B----------E--------E--------[]--------------X
XXXXXXXXXXXXXXXXXXXX------S---XXXXXXXXXXXXXXXXXXXXXXXXXXXXXXX--XXXXXEEXXXXXXXXXXXXXXXXXXXXXXXXXXXXXXXXXXXXXXXXXXXXXX-------------XXXXXXXXXXXXXXXEXXXXXXXXXXXXXX-XXXXXXXX-XXXXX--XXXXXXXXXXXXXXXXX
XXXXXXXXXXXXXXXXXXXX----------XXXXXXXXXXXXXXXXXXXXXXXXXXXXXXX--XXXXXXXXXXXXXXXXXXXXXXXXXXXXXXXXXXXXXXXXXXXXXXXXXXXXX-------------XXXXXXXXXXXXXXXXXXXXXXXXXXXXXX-XXXXXXXX-XXXXX--XXXXXXXXXXXXXXXXX
