---------------------------------------------------------------------------------------------------------------------------------------------------------------------------------------------------------------------------
---------------------------------------------------------------------------------------------------------------------------------------------------------------------------------------------------------------------------
----------------------------------------------------S----------------------------------------------------------------------------------------------------------------------------------------------------------------------
--S------------------------------------------------------------------------------------------------------------------------------------------------------------------------------------------------------------------------
---------------------------SSS----SSSS---------------------E--------------------------------------------------------------------------------------------------------------------------E------------------------------------
SS-SS---------XQQ?QQX--------------------------SSSSSS----QQQQQQQ----------------E-----------------------------------------------SSSSSSS---------------E------E------------------------S--------------------XX--------------
SS-SS---------X-----X----------------------------------------------------------SSSS----------------------------------------------------------------E----------------------------------------------------E------------------
--------------X-----X------X----------------------------------------------------------------------------------------------------------------------------------------------------------?-----------------X------------------
S-S-SSS-------XE-E--X------XEE-------X----------------------E--------------X-E--E------------------------------------------------E--E-----------XSSSSSSSSSSSS-----------------E----------------------E--X------------------
S-S-SSS-------XQQ-QQX------XSSSSSSSSSX------------------QQQQQQQQ-----------XS?SSSSS---X-----------------------------------------SSSSSSS--------XX-----------------------QQ----X-------E--------------X--X--------------S---
SSSSSSS----------------------------------------------------------------------------EE-X--------------------------------Q?QQQ------------------XXX----oooooo-------------------X-------X-----------E--X--X------------------
-S-S-SS-------------E---------------------------------------------------X--SSSSSSSSSSSX------------------------------------------------------XXXX-----------------------------X-------X-----------X--X--X------------SS-SS-
-S-S-SS-----------------------------------------------------------------X-------------------------------E-E---------------------------------XXXXX----oooooo-------------------X-------X-----------X--X--X--------X---SS-SS-
XXXXXXXXXXXXXXXXXXXXXXXXXXXXXXXXXXXXXX----XXX------XXXXXXXXXXXXXXXXXXXXXXXXXXXXXXXXXXXXXXXXXXXXXXXXXXXXXXXXXXXXXXXXXXXXXXXXXXXXXXXXX--XXXXXXXXXXXXXXXXXXXXXXX-----X--XXXXX--XXXXXXXXXXXX-XXXXXXX--X--X--X-----XXXXXXXXXXXXX
