-------------------------------------------------------------------------------------------------------------------------------------------------------------------------------------------------------------------------------
-------------------------------------------------------------------------------------------------------------------------------------------------------------------------------------------------------------------------------
S-----SSSSSSSSSSSSSSSSSSSSSSSSS?SSSSSSSSSSSSS-------------SS????SSSSSSSSSSSSSSSSSSSSSSSSSSSSSSSSS----SSSSSSSSSSSSSSSSSSSSSSSSSSSSSSSS-----SSSSSSSSSSSSSSSS-------------SSS--[]SSSSSSSSSSSSSSS---------------------------------S
S---------------------------------------SSSSS-----------SS-------------------------------------------SSSS---------------------------------SSSS------------------------------[]SSSSSSSSSSSSSSS-------------------XXXXXXXXXXXX--S
S---------------------------------------SSSSS--------SSS---------------------------------------------SSSS---------------------------------SSSS------------------------------[]SSSSSSSSSSSSSSS------------------XX-------------S
S---------------------------------------SSSSS--------------------------------------------------------SSSS----E----------------------------SSSS------------------------------[]SSSSSSSSSSSSSSS-----------------XXX-------------S
S---------------------------------------SSSSS---------------------------------------------------------------<>--------------------------------------------------------------[]SSSSSSSSSSSSSSS----------------XXXX-------------S
S---------------------------------------SSSSS-------S-------------------------------------------------------[]------------E----------------------------------XXX------------[]SSSSSSSSSSSSSSS---------------XXXXX-------------S
S--------------------------XXXXX-----E--SSSSS-----E-------XXXXX---------------------------XXX----------E----[]-----------<>----------------o---------------------------------]SSSSSSSSSSSSSSS--------------XXXXXX-------------S
S-------------------------XXXXXX----<>-----SS----<>------XXXXXX-------------------XXX-----------------<>---?SSS--E-------[]---------------S?SS---------XXX-------------------]SSSSSSSSSSSSSSS--------E----XXXXXXX-------------S
S--------------E---------XXXXXXX----[]-----SS----[]-----XXXXXXX-----------XXX-------------------------[]--------<>-------[]--<>-----E-----SSS-------------------SSS-S--SSSSSSSSSSSSSSSSSSSSSS---E---<>---XXXXXXXX-----<>------S
S-----------------------XXXXXXXX----[]-----SS----[]----XXXXXXXX---XXX---------------------------------[]--------[]---<>--[]--[]----<>-----SS--------------------SSS-S--SSSSSSSSSSSSSSSSSSSSSS--<>---[]--XXXXXXXXX-----[]------S
S---------------X-----XXXXXXXXXX----[]-----EE----[]---XXXXXXXXX---------------------------------------[]--------[]---[]--[]--[]----[]-------E-EE---X------------SSS-S--SSSSSSSSSSSSSSSSSSSSSS--[]---[]-XXXXXXXXXX-----[]------S
XXXXXXXXXXXXXXXXX-----XXXXXXXXXX--XXXXXXXXXXXXXXXXXXXXXXXXXXXXXX---------------------------------XXXXXXXXXX----XXX---XX--XX--XX--XXXXXXXXXXX-XXXXXXX---------XXXSSS-S--XXXXXXXXXXXXXXXXXXXXXX--XX---XXXXXXXXXXXXXXXXXXXXXXXXXXX
