--------------------------------------------------------------------------------------------------------------------------------------------------------------------------------------------------------------------------------------------------------------------
--------------------------------------------------------------------------------------------------------------------------------------------------------------------------------------------------------------------------------------------------------------------
---------------------E--------------------------------------------------------------------------E-------------------------------------------------------------------------------------------------------------------E-----------------------------------------------
--------------------o?o--------------------------E----------oQo---------------o-------------QSQSQ---------------------------------------------------------------o-o-------------------------------------------------QSQSQ-------------------------------------------
------------------------------------------------------------------------------------------------------------------ooo---------------E---------E-----------E------------------------E------------------------------------------------------ooo-------------------E---
----------------o-o--------------o---------------------------------------o---------o-----------------------------------------------------------------------------------------------?------------SSS--------o----------------------------------------------------o-o-
-------------------------------------E----E-----------------------------------------------------E------------------------------------------------------------E------------------------------------------------------------------------------------------------------
---------------XXXXXXXX--------------XXXXXXXXXXXXXXXXXXXXXXXXXX--------------XXX---o------XXXXXXXXX-XXX-----------------XXXXXXXXXXXXXXXXXXXXXXXXXXXXXXXXXXXXXXXX-------------------------------------------o------XXXXXXXXX-XXX--------------------------------XXXXX
-------------------------------------------------------------------------E-------------------------------------------XXX----------------------------------------------------------------------------------------------------------------SSS--XXX--------------------
------------------------------XXXXXXX---------------------------------XXXXXXX------o----------------------------------------------------------------------------------------------XXX----------------------o-----E--------------------------------------------------
-----XX-----------------------------------------------------------E--------------------XXXXX-------------SSS---------------------------------------------------------------------XXXXX-------------------------XXXXX---------------------------------XX-------------
-----XX---XXXXXX-------XXXXXXX---------------------------------XXXXXXX-------------------------X-X-Q----------------------------------------------------------------------------XXXXXXX----------------------------------X-Q-------------------------XX---XXXXXX----
---X-XX----------------------------------------------------X-------------------------------------X-----------------------------------------X-------------------X---------------XXXXXXXX----------------------------------X-------------------------X-XX-------------
---X-XX----------------------------------------------------X----------------------------------------------X--------------------------------X-------------------X--------------XXXXXXXXX-X--SSS------------------------------------X----------------X-XX-------------
--XXXXXXXX-------------------------------------------------X-----------------------XXXXX-------XXXXX------X----SSS-------------------------X-------------------X--XXXXXXX----XXXXXXXXXX-XX-----------------XXXXX-------XXXXX------X---------------XXXXXXXX----------
--XXXXXXXX-----------------------------------X------------------------------------------------------------X-X----------------X-------------------X--------------------------XXXXXXXXXXX-XXX----------SSS--------------------------X-X-------------XXXXXXXX----------
