-----------------------------------------------------------------------------------------------------------------------------------------------------------------------------------------------
-----------------------------------------------------------------------------------------------------------------------------------------------------------------------------------------------
-----------------------------------------------------------------------------------------------------------------------------------------------------------------------------------------------
-----------------------------------------------------------------------------------------------------------------------------------------------------------------------------------------------
---------------------------------------------------------------------------------------------------------------------------------------------------------------E-E-----------------------------
-------------------------------------------------------------------------------SSSSSSSSSSSSS-------------------SSS?SSS-------QQ?-------------QQQ?QQQ---------SSSSSSS-SS----------------X-------
--------------------------------------------------------------------------------------------------------------------------------------------------------------------E---------------E--X-------
------------------------------E----------------------------------------------------------------<>----------------------------------------------E------------------------------------XX-X-------
------------------------------<>------------------<>-----Q--Q--?--------------------SSSSS------[]----------------------------SSS-------------SSSSSSS--------------------------------XX-X-------
---------------QQQQQQQ------?-[]-------SSSSSS?----[]-----------------S------------SS----------QQQQQQ-----------SSSSSSS----------------<>--------------E--------------<>-------<>----XX-X-------
-------------------------<>---[]------------------[]---------------E------------<>----------------------------------------------------[]-------X------X-------E------[]-------[]----XX-X-------
---------------------E---[]---[]-------------S----[]-----------E----------------[]----------------------------------E-----------------[]-------X------X--------------[]-------[]----XX-X-------
-------------EE------X---[]---[]------------------[]---------------------X------[]----E---EE------------E-----------------------------[]----E--X------X--------------[]-------[]----XX-X-------
XXXXXXXXXXXXXXXXXXXXXX---XXXXXXX-XXXXX--XXXXXXX---XXXXXXXXXXXXXXXXXXXX---XXXXXXXXXXXXXXXXXXXXXXX-X-XXXXXXXXXXXXXXXXX-X-X--X-------XXXXXXXXXXXXXXXXXXXXXXXXXXXXXXXXXXXXX-------XX-XXXXX-XXXXXXXX
