--------------------------------------------------------------------------------------------------------------------------------------------------------------------------------------------------------------------------------------------------------------------------------------------------------------------------------------------------------------------------------------------------------------------------------------------------------
--------------------------------------------------------------------------------Q------------o--------------------------------------------------------------------------------------Q------------o------Q------------o----------------------------------------------------------------------------------------------------------------------------------------------------------------------------------------------------------------------------------
----------------------------------------------------------------------------------------------------E--------------------------------------------------------------------------------------------------------------------------------------------------------------------------------------------------------------------------------------------------------------------------------------------------------------QQQ----------------------------------
---------------------------------------------------------------------------------------------o----XXX--------------------------------------------------------------------------------------------o----XX----X--------o----XXX---------------------------------------------------------------------------------------------------------XX----------------------------------------------------------------------------------------------------------------
-------------------------------------------E----------------------------------------------------XXX-------------------------------------------------------------------------------------------------XXX-----------------XXX-------------------SSS----------------------------E----------------------------------------------------ooo-XX------------------XX---------------------------------------XX---------------------------------ooo---------------
----------------------------------------SSSS------------------------------------XX---------E-o--X-----------------------------------------------------------------------------------XX---------E-o--X---XX------E----o--X--------------------------E----------------oooooo--------------oooooo---B--------------------------------ooo----------------------------------------XX--------------------XX--------------ooo----------------oooXX-------------
-----------------------Q---------------------------------------Q-----------------XX---------------------------------------------------XX-X-----Q-------------------------------------XX------------------XX---------E------------------------------?----------------XXXXXX--------------XXXXXX---b--------------------------------ooo----------------------------------------XX-----------------------------------XXXX----------------oooXX-------------
--------------------------------QQ--------------------------------------QQ------------------XX----------------------------------------XXoX--------------QQ------------------------------------X-XX------------------XX--------------------------------------QQ--------------<>------------------<>----------------------------------------------------------------------------------------------XX------------------------------------------------------
--------------------------------------------------------------------------------------------XX-----------------------SSS-------o-XX-o-XXoX--------------------------------------------------E---XX------------------XX--------------SS--------------------------------------[]------------------[]--------------------------------XXX---------------------------------------------------------XXXX--------------------------XXX-------XXX---------------
----------------------------------------XXXX--------------------------------------XXXX--XXXXXX-----------SSS---------------------XX---XXoX--------------------------------------------XXXX--XXXXXX--------XXXX--XXXXXX-----------------------------B------------------------[]------------------[]--------------------------------XXX---------------------------------------------------------------------------------------XXX-------XXX---------------
------------------------------E------------------------------------------B-----------------------------------------------X--XX-o-XX-o-XXoX---------------B-----------------------------------------------------------------------------------------b---------B-------------XXX--------XX-------QQQ--------XXXX--------------------------------------XX------------------XX--------------------------------------------------XXX-------------------------
----------------------<>--------------------------------------<>---------b--------------------------------------------------XX---XX---XXoX----<>---------b----------------------------------------------------------------------------------------<>---------b------------------------XX---E--------------XXXX--------------------------------------XX------------------XX------------------------------------------------XXXXX-------------------------
----------------------[]--------<>----------------------------[]--------<>----------------------------------------------<>--XX-o-XX-o-XXo--X--[]--------<>-------------X--------------------------------------------------------------------------[]--------<>------------------------XX------------------XXXX--------------------------------------XX------------------XX------------------------------------------------XXXXX-------------------------
----------------------[]--------[]--E-------XXXX------XXE-----[]--------[]------------XX--------------------------------[]--XX---XX---XXo--X--[]--------[]------E----E-----E--------------XX------------------XX----------------------------------[]--------[]-------------E---E------XX------------------XXXX--------------------XX--XX--XX--XX--XXXX------------------XX------------------------------------------------XXXXX-------XX--XX--XX--XX--XX
XXXXXXXXXXXXXXXXXXXXXXXXXX---XXXXXXXXXXXXXXXX----------XXXXXXXXXXX---XXXXXXXXXXXXXXXXXXX--------------------------------XX--XX-o-XX-o-XXo--XXXXXXX---XXXXXXXXXXXXXXXXXXXXXXXXXXXXXXXXXXXXXXX------------XXXXXXXX------------------SSS-----------XXXXXX---XXXXXXXXXXXXXXXXXXXXXXXXXXXXXXXXXXXXXXXXXXXXXXXXXXXXXEEEEEEEEEEEEEEEEEEEEXXXXXXEEXXEEXXEEXXXXEEEEEEEEEEEEEEEEEEXXEEEEEEEEEEEEEEEEEEEEEEEEEEEEEEEEEEEEEE-----XXXX-XXXXXEEEEEEEXXXXXXEEXXEEXXEEXX
XXXXXXXXXXXXXXXXXXXXXXXXXX---XXXXXXXXXXXXXXXX----------XXXXXXXXXXX---XXXXXXXXXXXXXXXXXXX--------------------------------XX--XX---XX---XX-XXXXXXXXX---XXXXXXXXXXXXXXXXXXXXXXXXXXXXXXXXXXXXXXX------------XXXXXXXX--------------------------------XXXXXX---XXXXXXXXXXXXXXXXXXXXXXXXXXXXXXXXXXXXXXXXXXXXXXXXXXXXXXXXXXXXXXXXXXXXXXXXXXXXXXXXXXXXXXXXXXXXXXXXXXXXXXXXXXXXXXXXXXXXXXXXXXXXXXXXXXXXXXXXXXXXXXXXXXXXXXX-----XXXX-XXXXXXXXXXXXXXXXXXXXXXXXXXXXXX
