----------------------------------------------------------------------------------------------------------------------------------------------------------------------------
----------------------------------------------------------------------------------------------------------------------------------------------------------------------------
----------------------------------------------------------------------------------------------------------------------------------------------------------------------------
----------------------------------------------------------------------------------------------------------------------------------------------------------------------------
----------------------------------------------------------------------------------------------------------------------------------------------------------------------------
---------------------------------------------------------------------------?Q---------------------------------oooo----------------XXX---------------------------XXX---------
------------------------------------------------------------E---------------------------------------------------------------------------------------------------------------
---------------------------------------------E----------------------------------------------------------------------E-------------------------------------------------------
--------------------------------------------------------------------------QQ----------------------------------------------------------------E-------------------------------
--------------------EE-E----------------------------------------------------------------------------XXXXXXX-----------------XXXX-----------------ooooooooo--XXX-------------
-------XXXXXXXXXXXXXXXXXXXX---------XXXXXXXXXXXX--------------XXXXXXXX---------------------------------------XX--XX--XX----------------XX-----------------------------------
------XXXXX---------------X---------X----------X-----------------------------------E-----------------------------------------------------------------E----------------------
-----XXXXXX---------------X--XXXX---X----------X-XXXXXXXXXX--------------XXXXXXXXXXXXXXXX---------------------------------------------------XXXXXXXXXXXXXX------------------
XXXXXXXXXXX---------------X---------X----------X-X--------X--------------X--------------X--XXXXXXXX-----------------------------------------X------------X-------------XXXXX
