----------------------------------------------------------------------------------------------------------------------------------------------------------------------------------------XXXXXXXXXXXXXX--XXXXXXXXXXXXXXXXXXXXXXXXXXXXXXXXXXXXXXXXXXXXXXXXXXXXXXXXXXXXXXXXXXXXXXXXXXXXXXXX--XXXXXXX---XXXXXXXX
-------------------------------------------------------------------------------------------------------SSSSSSSSSS-----------------------------------------------------------------------X-----X------X------------------------------------------------------------------------------------XXXXX----------XXX
----------------------------------------------------------------------------------------------------------------------------------------------------SS-------------------------------o--X-----X------X---------------------------------------------------------------------------------------------------XXX
-------------------------------------------------------SS------------------------<>-----------------------------------------------------------------------------------------------------X-----X--XX--X---------------------------------------------------------------------------------------------------XXX
---X-----------------------------------------------------------X-----------------[]----------------------ooooooo-----------------------------------------------------------------X---o--X-----X---X--X-----X-------------------X-------------------------------------------------------------------------XXX
---------------------------------------------------------------------------------[]--------E-------------E------------------------------------------------------------------------------X-----X---X--X-------------------------------------------------------------------------------------------------X-XXX
---------------------------------------SSS---------------------------------------XX--------?-----------XXXXXXXXXX----------------------------S---------------------------------------o--X-XXX-X---X--X---------X----X--------------X----X-----------------------------------------------------X-------------
----------------------------------------------------------------------------------------------------------------------------------------------------------------------XXXX--XXXX--------X---X-XXX-X--X---------X----X-----E--------X----X-----------------------------------------------------X------EXX----
---------oo--------o---X-------------------X-------------------------oo--------o-------------------------------------------X-----------SSS-----X-------------------------------------o--X---X-----X--------X---X----X----------X---X----X----------X------X------------X------X---------------X--------X----
-----X------------------o-o-o-o-------------o-o-o-o--------------X------E------------------------------------------X--------o-o-o-o-------------o-o-o-o-------------X-------------------X---X-----X------------X----X--------------X----X----------E------X----XX------X------X----XX-------E-X--------X----
--------------------------SSS----SSS-----------SSS------------------------------------XXXX-X-X-XX---------QQQQ-----X----------------------------------------------------X-----------XX--XX--X-----X------------X----X-XXXXXX-------X----X-XXXXXX---?QQ----X---XX-------QQQ----X---XX--------E-X--------X-XXX
------------------------------------------------------------------------------E-------XXXX-X-X-XX--------------X---X--------------SSS-----------------------------------------------XX--X---X----XX------------X----X-XXXXXX-------X----X-XXXXXX---X------X--XX--------X---------XX-----------X----------XXX
---------<>---XX--XX-------------------------------------------------<>---XXSSXXXXXX--XXXX-X-X-XX--------------X-----------SSS------------------------------------<>-------------X--XX------X----XX------------X----X-XXXXXX------------X-XXXXXX---X------X-XX---------X------E-XX------------X----------XXX
---------[]---XX--XX-----------------X-------------------X-----------[]---XX--XXXXXX--XXXX-X-X-XX---XX---------X----XX-------------------X-------------------X----[]-------------XXXXX------X----XX-------------------XXXXXX------E-------XXXXXX-----------XX-------X----------XX---------XXX-------XXXXXXXX
-XXXXXX--[]---XX--XX-----------------------------------------XXXXXX--[]---XX--XXXXXX-XXXXX-X-X-XX---XX--------------XX-----------------------------------SSS----XXXXXX-----------X-----SS--------XXXXXXXXXXXXXXXXXXXXXXXXXXXXXXXXXXXXXXXXXXXXXXXXXXXXXXXXXXX--------XXXXXXXXXXXX----------XXXXXXX---XXXXXXXX
--XXXX---XX---XX--XX------------------------------------------XXXX---XX---XX--XXXXXX-XXXX--X-X-XX---XXXXXXXXXXXXXXXXXX------------------------------------------XXXXXX-----------X-------------SS-------XXXXXXXXXXXXXXXXXXXXXXXXXXXXXXXXXXXXXXXXXXXXXXXXXXXX--------XXXXXXXXXXXX----------XXXXXXX---XXXXXXXX
