XX--XXXXXXXXXXXXXXXXXXXXXXXXXXXX----XXXXXX--XXXXXXXXXXXXXXXXo-o-o-o------------X-----------XXXX---XXo-o-o-o------------X--X----------XXXXXXX-----------XXXX---XXXXXXXXXXXXXX----XXXX--X----------XXXXXXX----------------------------------------XX--XXXXXXXXXXXXXXXXXXXXXXXXXXXXXXXXXXXX-----------
XX--XXXXXXXXXXXXXXXXXXXXXXXXXXXX----XXXXXX--XXXXXXXXXXXXXXXXXXXXXXX<>----------XX---------XXXXX---XXXXXXXXX<>----------X--X---------XXXXXXXXX---------XXXXX---XXXXXXXXXXXXXX----XXXX--X---------XXXXXXXX----------------------------------------XX--XXXXXXXXXXXXXXXXXXXXXXXXXXXXXXXXXXXX-----------
XX--XXX--XXXXXXXXXXXXXXXX--XX-X-----X---XX--XXX--XXXXXXXXXXX--XXXXX[]----------XX---------X-XXX---XX-XXXXXX[]----------X--X---------XXXXXX-XX---------X-XXX---XXXXXXX---X-X-----X-X---X---------XXXXXX-X----------------------------------------XX--XXX--XXXXXXXXXXXXXXX-XXXXXXXXXXX---------------
XX---X---XXXXXXXXXXXX---X---X------X--E-XX---X---XXXXXXXXXXXE------XX----------XX------------------X-------XX----------X------------X-------X------------------XX---X-E-X-----------------------X-----------------------------------------------XX---X---XXXXXXXXXXX-X----XX---XXX-----------------
XX---X---XXXXXXXXX-X--------X-----------XX---X---XXXXXXXXX-X-------XX----------X------------E--------------XX----------X----------------E-------------------------------X-----------------------------------------------------------------------XX---X---XXXXXXXXX-X------X----XX------------------
-X---X----X----X---X-----E---------------X---X----X----X---X--------------------E----------------------------------------------------------------------------------------------------------------------------------------------------------------X---X---------X---X-------------------------------
---------------X-----------------------------------E-E-X------------------------------------------------------o-o-o-------------------------E------------------E-----------------------------------------------------------------------------------------E-----X-----------------------------------
--------------------------------QSQ----------------------------------------------------------------Q-----------------------------------------------------------?------------QSQ------------------------------------------------------------------------------------------------------XXX--------XXX
-------------------------------------------------------------------------------------------------------------------------------------E-------------------------------------------------------------------XX------------------XX-----------------------------------------SSS----------XXX--------XXX
-------------------------------------------------------------------------E----------------oooo-------------------X-------------------------------------ooo----------B-----------------------------E------XX------------------XX------------------------------------------------------XXX--------XXX
----------------------------------------------------------------------SQS?S-----------------------------------SQSQS---------E---------XX--XX------------------------b-----------------------------XX--XX-XX------------------XX-------------------------B--------------------------SS-XX---------X-
------------------<>---<>-------QSQ-----------------------<>----XX------------------------XXXX----XX----XX----------------XXXXXXXXXX--XX--XX----------XXXX----XX---<>-------QSQ-------XXXXXXXXXX--XX--XX-XXEEEEEEEEEEEE------XXEEEEEEEEEEEE-------------b-E-------<>------------E-----X------------
-------<>---------[]---[]----------------------<>---------[]----XX--------------------------------------XX----------------XXXXXXXXXX---X--XX-----------------------[]-----------------XXXXXXXXXX---X--XX-XXXXXXXXXXXXXX------XXXXXXXXXXXXXX------------<>---------[]----------XXXX----X------------
-------[]---------[]---[]-----------XX------E--[]---------[]-------------------X---------------------------------------X-----X-XX--X-------X----E------------------[]-----------XX-------X-XX--X-------X-XXXXXXXXXXXXXX------XXXXXXXXXXXXXX------------[]---------[]----------X-XX-----------------
XX--XXXXXXXXXXXXXXXXXXXXXXXX--------XXXXXX--XXXXXXXXXXXXXXXXXX-------XXXXXXXX--XXXX-XXXXX-----------XX-------XXXXXXXX--X-------X-----------XXXX-XXXXX-----------XXXXXXXX--------XXXX-------X-----------X----------------------------------------XX--XXXXXXXXXXXXXXXXXXX----------------------------
XX--XXXXXXXXXXXXXXXXXXXXXXXXXXXXXXXXXXXXXX--XXXXXXXXXXXXXXXXXX-------XXXXXXXX--XXXX-XXXXX-----------XX-------XXXXXXXX--X--------------------XXX-XXXXX-----------XXXXXXXXXXXXXXXXXXXX------------------------------------------------------------XX--XXXXXXXXXXXXXXXXXXX----------------------------
